##----------------------------------##-----------------------------------##
---------------------------------------------------------------------------
---------------------------------------------------------------------------
---------------------------------------------------------------------------
---------------------------------------------------------------------------
----********------******----**********---**********--**--------********----
----*********----********---**********---**********--**--------********----
----**-----**----**----**-------**-----------**------**--------**----------
----**-----**---***----***------**-----------**------**--------**----------
----**-----**---**------**------**-----------**------**--------**----------
----********----**------**------**-----------**------**--------*****-------
----*********---**********------**-----------**------**--------*****-------
----**-----***--**********------**-----------**------**--------**----------
----**------**--**------**------**-----------**------**--------**----------
----**-----***--**------**------**-----------**------**--------**----------
----**********--**------**------**-----------**------********--********----
----*********---**------**------**-----------**------********--********----
---------------------------------------------------------------------------
---------------------------------------------------------------------------
---------------------------------------------------------------------------
---------------------------------------------------------------------------
-------------------*****----**********---**********--**----**--------------
------------------********--**********---**********--**----**--------------
-----------------***----**------**-----------**------**----**--------------
----------------***-------------**-----------**------**----**--------------
----------------**--------------**-----------**------***--***--------------
----------------**--------------**-----------**------********--------------
----------------**--------------**-----------**-------******---------------
---------E------**--------------**-----------**--------****----------------
----------------**--------------**-----------**---------**-----------------
----------------***-------------**-----------**---------**-----------------
-----------------***----**------**-----------**---------**--------E--------
------------------********--**********-------**---------**-----------------
-------------------*****----**********-------**---------**-----------------
---------------------------------------------------------------------------
---------------------------------------------------------------------------
---------------------------------------------------------------------------
---------------------------------------------------------------------------
------------------------------------B--------------------------------------
---------------------------------------------------------------------------
---------------------------------------------------------------------------
---------------------------------------------------------------------------
%%-----------------------------------------------------------------------%%
%%------------------------------**********-------------------------------%%
%%%%----------------------------**********-----------------------------%%%%
%%%%----------------------------**------**-----------------------------%%%%
##%%%%--------------------------**------**---------------------------%%%%##
##%%%%--------------------------**------**---------------------------%%%%##
####%%%%---------------------P--**------**-------------------------%%%%####
####%%%%------------------------**------**-------------------------%%%%####
